##########
#P   T   #
# ## ### #
#  A   #S#
##########